A       A
E		E
N		N
I		I
S		S
R		R
A		A
T		T
D		D
H		H
U		U
L		L
C		C
G		G
M		M
O		O
B		B
W		W
F		F
K		K
Z		Z
P		P
V		V
J		J
Y		Y
XX		X
QQ		Q
XA		ICH
XB		EIN
XC		UND
XD		DER
XE		NDE
XF		SCH
XG		DEN
XH		DIE
XI		END
XJ		CHT
XK		VON
XL		DAS
XM		MIT
XN		ION
XO		EUR
XP		SICH
XQ		UNG
XR		NICHT
XS		SIE
XT		DIE
XU		IST
XV		DES
XW		SICH
XY		AUCH
XZ		NACH
